
WE ./texters/4.xpm 
NO ./texters/1.xpm


SO ./texters/2.xpm


     EA ./texters/3.xpm




      F  6,7,11    
      C 6,7,11


            1111111111111111111111
           11E00000000000000001                   1
           111111111111111111111

            



