
WE ./texters/4.xpm 
              NO ./texters/1.xpm


SO ./texters/2.xpm


     EA ./texters/3.xpm




      F  6,7,11      
      C 34,46,151


        1111111111111111111111111111111111111111111111111111111         
 1 11  1110000000000000000000000000000000000000000000011111111111111111111111111111111111     
    11110101100000000000000000000000000000000000000000000000000000000000000000000000001    
        1 1 1000000000000000000000000000000000000000000001111111111111111111111111111111111111
            100100000000000000000000000000000000000000001
    11111111111 100000000000000E00000000000000000000000001    
     1000000000110000000000000000100000000000000001111111                1
11111111111111111111111111111111111111111111111111111111111111111111111111111111111
1111111111111111111111111111111111111111111111111111111111111


