


        WE       ./texters/4.xpm 
              NO ./texters/1.xpm
SO ./texters/2.xpm
EA ./texters/3.xpm







      F  6,7,11      
      C 34,46,151     

111111111111111111  111111111111111111111111111
10000000000000000000000000000000000000000000011111111111111111111111111111111111
101011E00000000000000000000000000000000000000000000000000000000000000000000000001
1000000000000000000000000000000000000000000001111111111111111111111111111111111111
100000000000000000000000000000000000000000001
100000000000000000000000000000000000000000001
111111111111111111111111111111111111111111111

100000000000000000000000000010000000000000001
111111111111111111111111111111111111111111111




