
NO texters/1.xpm
WE ./texters/4.xpm 
SO ./texters/2.xpm
     EA ./texters/3.xpm





      F  6,7,q
      C 34,46,151 

11111111
10000001
10000001
10000001
10000001
10000001
1000N001
11111111