
NO ./texters/1.xpm 

SO ./texters/2.xpm


WE ./texters/4.xpm 




EA ./texters/3.xpm




      F  6,7,11    
      C 6,7,11


1111111111111111111111111111111111111111
1E01000000000000001100000000000000000001            
1111000000000000000000000000000000000001            
1000000000000000000000000000000000000001            
1000000000000000000000000000000000000001            
1000000001000000000000000000000000000001            
10000000000000000111100000000000000000001            
1000000001000000000000000000000000000001            
1000000000000000000000000000000000000001            
10000000110000000011110000000000000000001            
1000000000000000000000000000000000000001            
1000000000000000000000000000000000000001            
1000000000000000000000000000000000000001            
1000000000000000000000000000000000000001            
1111111111111111111111111111111111111111



