
WE ./texters/4.xpm 
              NO ./texters/1.xpm


SO ./texters/2.xpm


     EA ./texters/3.xpm




      F  6,7,11    
      C 255,46,151


            11011  1111111111111
           101E1                   1
           11111111111111111

