1111111111
1000000001
1010110101
1010100001
1000100001
1000001101
1010010001
1001000001
1000100001
1111111111