11111111111111111111
10000001111000010001
10000010000000000001
11000000000000000001
10000000000000000001
10000000000000010001
10100000000100100001
10000000000000010001
10000000000000010001
11111111111111111111