11111111111111111111
10000001111000010001
10000010000000000001
11000000000000001001
10000000001110100001
10000000000000010001
10000000000100100001
10000000000000010001
10000000000000010001
11111111111111111111