1111111111
1000000001
1010110101
1010000001
1000000001
1000000001
1000000001
1000000001
1000000001
1111111111