1111111111
1000000001
1010110101
1010000101
1011110101
1000010101
1010110001
1000100101
1000000001
1111111111