111k11
100101
101001
1100N1
1z1111