1111111111111111111111
1001000000000000000001
101000000000000P000001
1100000000000000000001
1111111111111111111111