11111111111111111111
10000000000000000001
10000010000000000001
10000000000000000001
11111111111100100001
10000000000100100001
10000000000100100001
10000000000100110001
10000000000000010001
10001111110000010001
10010000000000010001
10000000000000010001
10000000000000000001
10001111111110000001
10111000000000010001
10000000000000010001
10000000001111110001
10000000000000000001
10000000000000000001
11111111111111111111