11111111111111111111
11111111111111111101
10000010000000000001
11110111111111111111
10000000000000100001
11111111101111111111
10000000000100100001
11111111111011111111
10000000000000010001
11111111111111111111