

WE ./texters/10.xpm 
              NO      ./texters/1.xpm
SO ./texters/2.xpm
EA ./texters/3.xpm




      F  0,15,0      
      C 0,20,0     

111111111111111111111111111111111111111111111
100000E00000000000000000000000000000000000001
101011000000000000000000000000000000000000101
100000000000000000000000000000000000000000001
100000000000000000000000000000000000000000001
100000000000000000000000000000000000000000001
100000000000000000000000000010000000000000001
100000000000000000000000000000000000000000001
100000000000000000000000000000000000000000001
100000000000000000000000000000000000000000001
100000000000000000000000000000000000000000001
100000000000000000000000000000000000000000001
100000000000000000000000000000000000000000001
100000000000000000000000000000000000000000001
111111111111111111111111111111111111111111111


