111111111111
100000000001
100000010001
111111011001
100001000101
100001100101
101100000101
100000000101
100111111001
100000000001
100100000001
111111111111