11111111111111111111
10P00000000000000001
10000000000000000001
11100000000111110001
10001111111100010001
10000000000000010001
10000000000000010001
10000000000000010001
10010010000000000001
10010010000000000001
10010010000000000001
10010011111111100001
10010000000000100001
10010000000000000001
10010000000000000001
10000011111111000001
10000000000000000001
10000000000000000001
11111111111111111111