11111111111111111111
10000000000000000001
10000000000001000001
11111100000001000001
10000100000001000001
10000100000001010001
10000111110001110001
10000000P00000000001
10000000000000000001
10111111111000111101
10000000000000100001
10000000000010100001
11111111100010010001
10000000100010010101
10000000100010010101
10000000000000010101
10111100000000000101
10000111111100011101
10000000000000000001
11111111111111111111