

WE ./texters/4.xpm 
              NO      ./texters/2.xpm
SO ./texters/1.xpm
EA ./texters/3.xpm





      F 213,255,0      
                        C                   225,30,0     


1111111111111111111111111
1000000000110000000000001
1011000001110000000000001
1001000000000000000000001
1111111110110000011100001
1111
1000000000111100000011010101111111
10000000000000001100000010001
10000000000000001101010010001
11000001110101011111011110N0111
11110111 1110101 101111010001
11111111 1111111 111111111111111111111111111111111
11110111111111011111111
111111111111111111

