

WE ./texters/4.xpm 
              NO      ./texters/2.xpm
SO ./texters/1.xpm
EA ./texters/3.xpm





      F 213,255,0      
                        C                   21,21,1


1111
10E1
1111






