

NO ./texters/2.xpm
SO ./texters/1.xpm
WE ./texters/3.xpm
EA ./texters/4.xpm 

F 0,255,0      
                        C                    225,30,0  

111111111111111111111111
1000000000110000000000001
1011000001110000000000001
1001000000000000000000001
111111111011000001110000000000001
10000000001111000000110101011100000010001
10000000000000001100000010001
10000000000000001101010010001
11000001110101011111011110N0111
11110111 1110101 101111010001
11111111 1111111 111111111111000001110111111111111
111101111N11111011100000010001
111111111111111111





