

WE ./texters/10.xpm 
              NO      ./texters/12.xpm
SO ./texters/13.xpm
EA ./texters/14.xpm





      F 9,05,0      
                        C                   0,0,255     


1111111111
100000E001
1010110101
1000000001
1000000001
1000000001
1111111111

