

WE ./texters/10.xpm 
              NO      ./texters/1.xpm
SO ./texters/3.xpm
EA ./texters/2.xpm





      F 9,05,0      
                        C                   0,0,255     


1111111111
100000S001
1010110101
1000000001
1000000001
1000000001
1111111111

