

WE ./texters/4.xpm 
              NO      ./texters/2.xpm
SO ./texters/1.xpm
EA ./texters/3.xpm





      F 213,255,0      
                        C                   225,30,0     


1111111111
100000E00111
1111111111001111
101011010111      
1111111111

