

NO ./texters/2.xpm
SO ./texters/1.xpm
WE ./texters/3.xpm
EA ./texters/4.xpm 

F 0,255,255         
                        C                    225,30,0  

111111
100101
101001
1100N1
111111